

   NO       ./textures/greystone.xpm  

  SO     ./textures/bluestone.xpm                
   
    F    220  ,  100,0  
	 
   WE    ./textures/red.xpm  
   
   EA    ./textures/wood.xpm 
  

   
   C   225,30  ,  0  

1111111        1111111    1111111    1111111111
1000001        1000001    1000001    1000000001
 1000001       1000001    1000001    1011111111
1001111        1111001    1001111    101
1001              1001    1001       1011111111
1001              1001    1001       1000000001
1001              1001    1001       1011111111
1001      111     1001    1001       101
10011111110001111110011111100111111111011111111
10000000000100000000000000000000000000000000001
11111111111 11111111111111111111111111111111111