

   NO       ./textures/greystone.xpm  

  SO     ./textures/bluestone.xpm                
   
    F    220  ,  100,0  
	 
   WE    ./textures/red.xpm  
   
   EA    ./textures/wood.xpm 
  

   
   C   225,30  ,  0  

1111111        1111111    1111111111    1111111111
1000001        1000001    1000000001    1000000001
 1000001       1000001    1011100001    1011111111
 100011        1111001    101 101111    101
10001             1001    101 101       1011111111
10001             1001    101 101       1000000001
10001             1001    101 101       1011111111
10101     111     1001    101 101       101
10101111110001111110011111101 10111111111011111111
10100000000100000000000000001 100000000000000001
11111111111 11111111111111111 11111111111111111111