

   NO       ./textures/greystone.xpm  

  SO     ./textures/bluestone.xpm                
   
    F    220  ,  100,0  
	 
   WE    ./textures/red.xpm  
   
   EA    ./textures/wood.xpm 
  

   
   C   225,30  ,  0  


111111   1111111 1111
100001   1000001 1001
100001   1000001 1001
100111   1000001 1001
1001     1000001 1001
100111011100000111001
100000000000000000001
111111111111111111111