NO ./textures/bluestone.xpm
SO ./textures/wood.xpm
WE ./textures/wood.xpm
F 119,181,254
EA ./textures/greystone.xpm
C 119,181,254



EA ./textures/greystone.xpm



111111111111111111111111
100000000000000000000001
100000000000000000000001
100000000000000000000001
100000000000000000000001
100000000000000000000001
100000111100000110000001
100000100100000110000001
100000111100000110000001
100000000000000000000001
100000000000000000000001
100000000000000000000001
100000000000000000000001
100000111000000000000001
100000101000000000000001
100000111000000000000001
1000000000000000N0000001
100000000000000000000001
100000000000000000000001
100000000000000000000001
100000000000000000000001
111111111111111111111111