

   NO       ./textures/greystone.xpm  

  SO     ./textures/bluestone.xpm                
   
    F    220  ,  100,0  
	 
   WE    ./textures/red.xpm  
   
   EA    ./textures/wood.xpm 
  

   
   C   225,30  ,  0  


  1  1
 10111
 1011
 1N1
11111111111
  1