

   NO       ./textures/greystone.xpm  

  SO     ./textures/bluestone.xpm                
   
   
   WE    ./textures/red.xpm  
   
  
  F    220  ,  100,0  
   
   C   225,30  ,  0  


  1  
 1011
 1011
 101
11111111111