

   NO       ./textures/greystone.xpm  

  SO     ./textures/bluestone.xpm                
   
   
   WE    ./textures/red.xpm  
   
   EA    ./textures/wood.xpm 
  
  F    220  ,  100,0  
   
   C   300,30  ,  0  


  1  
 1011
 1011
 101
11111111111