

   NO        ./textures/red.xpm  

  SO     ./textures/wood.xpm                
   
    F    220  ,  100,0  
	 
   WE     ./textures/greystone.xpm
   
   EA      ./textures/bluestone.xpm 
  

   
   C   225,30  ,  0  

1111111             111111111111    1111111111                1111111111
1000001             100000000001    1000000001            1000000001
1000001             100000000001    1000000001             1000000001
1000001             100000000001    1000000001              1000000001
1000001             100000000001    1000000001             1000000001
1000001             100000111111    1000000001             1000000001
 1000001            100000111       1000000001           1011111111
 10000011           1000001         1111000001           101111    101
100000111           1000001            1000001             101       1011111111
1000001             1000001            1000001      101       1000000001
1000001             1000001            1000001            101       1011111111
1000001  1111111    10000011           1000001           101       101
1000001111000001111110000011111111111111000001110000011011111111
10000000000000000000000000000000000000000000000000000001
100000000000000000000000000000000000000000000000001
10000000000000000000000000000000000000000000000000000001
1000000000000000000000000000000000000000000000000000001
10000000000100000000000000000000000000000000000000000001
10000000000100000000000000000000000000000000000000000001
11111111111111111111111111111111111111111111111111