NO ./textures/bluestone.xpm
SO ./textures/wood.xpm
F 128,128,128
WE ./textures/red.xpm
EA ./textures/greystone.xpm
C 119,181,254 

1111111             111111111111    111111111111111111111           111111111111
1000001             100000000001    100000000000000000001           100000000001
1000001             100000000001    100000000000000000001           100000000001 
1000001             100000000001    100000000000000000001           100000000001  
1000001             100000000001    100000000000000000001           100000000001 
1000001             100000111111    100000000000000000001           100000000001 
 1000001            100000111       100000000111000000001           100000111111
 10000011           1000001         1111000001 1000001111           1000001
100000111           1000001            1000001 1000001              100000111111
1000001             1000001            1000001 1000001              100000000001
1000001             1000001            1000001 1000001              100000000001
1000001  1111111    10000011           1000001 1000001              100000000001
1000001111000001111110000011111111111111000001 1000001              100000000001
1000000000000000000000000000000000000000000001 100000111111111111111100000000001
1000000000000000000000000000000000000000000001 100000000000000000000000000111111
10000000000000000000000N0000000000000000000001 10000000000000000000000000011
1000000000000000000000000000000000000000000001 1000000000000000000000000001111
1000000000000000000000000000000000000000000001 100000000000000000000000011111
1000000000000000000000000000000000000000000001 10000000000000000000000001
1000000000010000000000000000000000000000000001 1000000000000000000000000111
1000000000010000000000000000000000000000000001 100000000000000000000000001
1111111111111111111111111111111111111111111111 1111111111111111111111111111